x,y
200,400
300,130
120,200
200,270
280,200
200,356
350,350
350,500
500,500
510,390
0,1,2,3,4,5,6,7,8,9
0,1,0,0,0,0,0,1,1,0
1,0,1,1,1,0,0,0,0,0
0,1,0,1,0,0,0,0,0,0
0,1,1,0,1,1,0,0,0,0
0,1,0,1,0,0,0,0,0,0
0,0,0,1,0,0,1,0,0,1
0,0,0,0,0,1,0,1,0,0
1,0,0,0,0,0,1,0,0,0
1,0,0,0,0,0,0,0,0,1
0,0,0,0,0,1,0,0,1,0