x,y
100,130
50,200
100,270
450,270
500,200
450,130
275,200
0,1,2,3,4,5,6
0,1,1,0,0,1,1
1,0,1,0,0,0,0
1,1,0,1,0,0,1
0,0,1,0,1,1,1
0,0,0,1,0,1,0
1,0,0,1,1,0,1
1,0,1,1,0,1,0