x,y
100,150
100,350
175,350
175,300
225,300
255,350
300,350
300,150
325,150
200,50
75,150
0,1,2,3,4,5,6,7,8,9,10
0,1,0,0,0,0,0,0,0,0,1
1,0,1,0,0,0,0,0,0,0,0
0,1,0,1,0,0,0,0,0,0,0
0,1,1,0,1,0,0,0,0,0,0
0,1,0,1,0,1,0,0,0,0,0
0,0,0,0,1,0,1,0,0,0,0
0,0,0,0,0,1,0,1,0,0,0
1,0,0,0,0,0,1,0,1,0,0
1,0,0,0,0,0,0,1,0,1,0
0,0,0,0,0,0,0,0,1,0,1